6 10
|--------|
|G..|.P..|
|........|
|GG...@|.|
|..G...|P|
|--------|